{
 "width": 28,
 "height": 36,
 "maze": [
 "____________________________" +
 "____________________________" +
 "____________________________" +
 "||||||||||||||||||||||||||||" +
 "|............||............|" +
 "|.||||.|||||.||.|||||.||||.|" +
 "|o||||.|||||.||.|||||.||||o|" +
 "|.||||.|||||.||.|||||.||||.|" +
 "|..........................|" +
 "|.||||.||.||||||||.||.||||.|" +
 "|.||||.||.||||||||.||.||||.|" +
 "|......||....||....||......|" +
 "||||||.||||| || |||||.||||||" +
 "_____|.||||| || |||||.|_____" +
 "_____|.||          ||.|_____" +
 "_____|.|| |||--||| ||.|_____" +
 "||||||.|| |______| ||.||||||" +
 "      .   |______|   .      " +
 "||||||.|| |______| ||.||||||" +
 "_____|.|| |||||||| ||.|_____" +
 "_____|.||          ||.|_____" +
 "_____|.|| |||||||| ||.|_____" +
 "||||||.|| |||||||| ||.||||||" +
 "|............||............|" +
 "|.||||.|||||.||.|||||.||||.|" +
 "|.||||.|||||.||.|||||.||||.|" +
 "|o..||.......  .......||..o|" +
 "|||.||.||.||||||||.||.||.|||" +
 "|||.||.||.||||||||.||.||.|||" +
 "|......||....||....||......|" +
 "|.||||||||||.||.||||||||||.|" +
 "|.||||||||||.||.||||||||||.|" +
 "|..........................|" +
 "||||||||||||||||||||||||||||" +
 "____________________________" +
 "____________________________"));
 ],
 "legend": {
   "_": "empty_space",
   "|": "wall",
   ".": "pellet",
   "o": "power_pellet",
   " ": "corridor"
 }
}
