{
 "width": 28,
 "height": 36,
 "maze": [
   "__",
   "__",
   "__",
   "||||||||||||||||||||||||||||",
   "|............||............|",
   "|.||||.|||||.||.|||||.||||.|",
   "|o||||.|||||.||.|||||.||||o|",
   "|.||||.|||||.||.|||||.||||.|",
   "|..........................|",
   "|.||||.||.||||||||.||.||||.|",
   "|.||||.||.||||||||.||.||||.|",
   "|......||....||....||......|",
   "||||||.||||| || |||||.||||||",
   "|.||||| || |||||.|",
   "|.||          ||.|",
   "|.|| |||--||| ||.|",
   "||||||.|| |__| ||.||||||",
   "      .   |__|   .      ",
   "||||||.|| |__| ||.||||||",
   "|.|| |||||||| ||.|",
   "|.||          ||.|",
   "|.|| |||||||| ||.|",
   "||||||.|| |||||||| ||.||||||",
   "|............||............|",
   "|.||||.|||||.||.|||||.||||.|",
   "|.||||.|||||.||.|||||.||||.|",
   "|o..||.......  .......||..o|",
   "|||.||.||.||||||||.||.||.|||",
   "|||.||.||.||||||||.||.||.|||",
   "|......||....||....||......|",
   "|.||||||||||.||.||||||||||.|",
   "|.||||||||||.||.||||||||||.|",
   "|..........................|",
   "||||||||||||||||||||||||||||",
   "__",
   "__"
 ],
 "legend": {
   "_": "empty_space",
   "|": "wall",
   ".": "pellet",
   "o": "power_pellet",
   " ": "corridor"
 }
}
